..............................
.  P        .         T .   E.
. ....... ...B....... ... ....
.      T.        .     .    T.
.......... ... . .B...T... ...
.        .       .       .   .
. ...... . ....... ....... ...
.      . . .     T       . . .
...... . . . ......... . . . .
.      .             .B. . . .
. ....... . . ........   . . .
.  T T   B.         .        .
..............................