........................
.                      .
. T   T TTTTT  TTTT  T .
.  T T  T     T      T .
.   T   TTT    TTT   T .
.   T   T         T    .
.   T   TTTTT TTTT   B .
.                      .
. P                  E .
........................