..................
.                .
. B   B  BBB   B .
. BB  B B   B  B .
. B B B B   B  B .
. B  BB B   B    .
. B   B  BBB   T .
.                .
. P            E .
..................